owner	repo
Iroski	SE-group-90
Iroski	cm_dns
iluwatar	java-design-patterns
macrozheng	mall
ReactiveX	RxJava
spring-projects	spring-framework
square	retrofit
apache	dubbo
airbnb	lottie-android
NationalSecurityAgency	ghidra
skylot	jadx
crossoverJie	JCSprout
apolloconfig	apollo
jeecgboot	jeecg-boot
proxyee-down-org	proxyee-down
xkcoding	spring-boot-demo
greenrobot	EventBus
scwang90	SmartRefreshLayout
dbeaver	dbeaver
lenve	vhr
Netflix	Hystrix
SeleniumHQ	selenium
alibaba	easyexcel
seata	seata
halo-dev	halo
xuxueli	xxl-job
ReactiveX	RxAndroid
google	ExoPlayer
DrKLO	Telegram
elunez	eladmin
linlinjava	litemall
mybatis	mybatis-3
Tencent	tinker
dianping	cat
EnterpriseQualityCoding	FizzBuzzEnterpriseEdition
apache	rocketmq
openzipkin	zipkin
lgvalle	Material-Animations
alibaba	ARouter
Tencent	QMUI_Android
orhanobut	logger
material-components	material-components-android
Anuken	Mindustry
Curzibn	Luban
android-hacker	VirtualXposed
greenrobot	greenDAO
mockito	mockito
Tencent	APIJSON
apache	hadoop
baomidou	mybatis-plus
youth5201314	banner
Netflix	zuul
apache	druid
GoogleContainerTools	jib
sqshq	piggymetrics
LuckSiege	PictureSelector
antlr	antlr4
Netflix	eureka
pagehelper	Mybatis-PageHelper
